####################
####     ###    ####
###  MM       ######
##  M           ####
###       ###  M ###
####     ###  M  ###
#####     ##   #####
#######   ##########
####################