####################
####     ###    ####
###           ######
##              ####
###     ####     ###
####     ###     ###
#####     ##   #####
#######   ##########
####################